1 1 1 1 1 1 1 1 1 1 1 1 1 1 1 1 1 1 1 1 1 1 1 1 1 1 1 1 1 1 1 1-
1 1 1 1 1 1 1 1 1 1 1 1 1 1 1 1 1 1 1 1 1 1 1 1 1 1 1 1 1 1 1 1-
1 1 1 1 1 1 1 1 1 1 1 1 1 1 1 1 1 1 1 1 1 1 1 1 1 1 1 1 1 1 1 1-
1 1 1 1 1 1 1 1 1 1 1 1 1 1 1 1 1 1 1 1 1 1 1 1 1 1 1 1 1 1 1 1-
1 1 1 1 1 1 1 1 1 21 22 0 0 0 0 21 22 0 0 0 0 0 0 1 1 1 1 1 1 1 1 1-
1 1 1 1 1 1 1 1 0 10 18 8 8 8 8 19 18 8 8 8 8 8 8 27 1 1 1 1 1 1 1 1-
1 1 1 1 1 1 1 1 0 10 20 20 20 20 20 20 20 20 20 20 20 20 16 28 1 1 1 1 1 1 1 1-
1 1 1 1 1 1 1 1 0 10 20 16 9 9 9 17 16 9 9 9 17 20 11 0 1 1 1 1 1 1 1 1-
1 1 1 1 1 1 1 1 0 10 20 11 0 0 0 23 24 0 0 0 10 20 11 0 1 1 1 1 1 1 1 1-
1 1 1 1 1 1 1 1 0 10 20 11 0 1 1 1 1 1 1 0 10 20 11 0 1 1 1 1 1 1 1 1-
1 1 1 1 1 1 1 1 0 10 20 11 0 1 1 1 1 1 1 0 10 20 11 0 1 1 1 1 1 1 1 1-
1 1 1 1 1 1 1 1 25 19 20 18 27 1 1 1 1 1 1 25 19 20 18 27 1 1 1 1 1 1 1 1-
1 1 1 1 1 1 1 1 26 17 20 16 28 1 1 1 1 1 1 26 17 20 16 28 1 1 1 1 1 1 1 1-
1 1 1 1 1 1 1 1 0 10 20 11 0 1 1 1 1 1 1 0 10 20 11 0 1 1 1 1 1 1 1 1-
1 1 1 1 1 1 1 1 0 10 20 11 0 1 1 1 1 1 1 0 10 20 11 0 1 1 1 1 1 1 1 1-
0 0 0 0 21 22 0 0 0 10 20 11 0 1 1 1 1 1 1 0 10 20 11 0 0 0 21 22 0 0 0 0-
8 8 8 8 19 18 8 8 8 19 20 11 0 1 1 1 1 1 1 0 10 20 18 8 8 8 19 18 8 8 8 8-
20 20 20 20 20 20 20 20 20 20 20 18 27 1 1 1 1 1 1 25 19 20 20 20 20 20 20 20 20 20 20 20-
9 9 9 9 17 16 9 9 9 9 9 9 28 1 1 1 1 1 1 26 9 9 9 9 9 9 17 16 9 9 9 9-
0 0 0 0 23 24 0 0 0 0 0 0 0 1 1 1 1 1 1 1 0 0 0 0 0 0 23 24 0 0 0 0-
1 1 1 1 1 1 1 1 1 1 1 1 1 1 1 1 1 1 1 1 1 1 1 1 1 1 1 1 1 1 1 1-
1 1 1 1 1 1 1 1 1 1 1 1 1 1 1 1 1 1 1 1 1 1 1 1 1 1 1 1 1 1 1 1-
1 1 1 1 1 1 1 1 1 1 1 1 1 1 1 1 1 1 1 1 1 1 1 1 1 1 1 1 1 1 1 1-
1 1 1 1 1 1 1 1 1 1 1 1 1 1 1 1 1 1 1 1 1 1 1 1 1 1 1 1 1 1 1 1

